   **************************************************
*                 ^                           |    $*
*                             ^               |     *
***********************************************-----*
*                        *                          *
*           %            *          &               *
*        %               *        ***               *
*               %        *            ***           *
*        %               *                          *
***********------*********                          *
*                        |       *** %              *
*                        |                   *** %  *
*                        |                          *
*********-------**********                          *
*                        *                          *
*            %           *       ***                *
*                        *            ***           *
*       %                *              &           *
*               %        *                       *==*
*      %                 *  %                    * #*
*****************************************************