   **************************************************
*                                              %    *
*                            ^                      *
*     ****        ^                        ****     *
*        *                      ^          *        *
*        *    %                            *        *
*        *                                 *        *
*        *        *****************        *        *
*        *        *   %%%       =#*        *        *
*        *        *             ==*        *  &     *
*    %   *        *---------------*        *        *
*        *        |       $$$     *        *        *
*        *        *               *        *        *
*        *        *****************        *      ^ *
*    &   *                                 *        *
*        *                            %    *        *
*        *         ^                       *        *
*     ****                        ^        ****     *
*   ^      %                                        *
*                                     ^             *
*****************************************************
