   **************************************************
*                                              ^ %  *
*                                              ^  % *
*                                              ^ %  *
*                                              ^^^^^*
*                                                   *
*                                                   *
*|||||||||||||||||||||||||||||||||||||||||||||||||||*
*                                      $% %$        *
*                                      $ % $        *
*                                      $$$$$        *
*                                                   *
*                                                   *
*                                                   *
*---------------                                    *
*              -                                    *
*            & -                                    *
*            & -                                    *
*    %%%%%%%%& -                                  ==*
*  %%%%%%%%%%& -                                  =#*
*****************************************************