   **************************************************
*                                              %    *
*                            ^                      *
*     ****        ^                        ****     *
*        *                      ^          *        *
*        *    %                            *        *
*        *                                 *        *
*        *        *****************        *        *
*        *        *               *        *        *
*        *        |      $$$      *        *  &     *
*    %   *        *---------------*        *        *
*        *        *            == *        *        *
*        *        *            = #*        *        *
*        *        *****************        *      ^ *
*    &   *                                 *        *
*        *                            %    *        *
*        *         ^                       *        *
*     ****                        ^        ****     *
*   ^      %                                        *
*                                     ^             *
*****************************************************
