   **************************
*  * $$           -   *     *
*  *              *   *=*** *
*  ***********  ***       * *
*    ^     |      *  **  &*#*
*****************************